11111111111111111111111111111111111
10010C00000000001000000000000000001
1010111110C010001000000100011111001
10001000000001010000001100000001001
10001000000000100C00010100000001001
1000111100E000100000100100011111001
10001000000000100010001000100000011
10001000000000000001111110010000001
110010C0000000100000000100011111001
1P0000000C00C0100000000000000000001
11111111111111111111111111111111111