11111111111111111111111111111111111
10010C00000000000000000000000000001
100E111110C010001000000100011111001
10011000000001010000001100000001001
10001000000000100C0001010C000001001
1000111100F000100000100100011111001
10001000000000000010001000100000011
10001000000000100001111110010000001
110010C0000000100000000100011111C01
1P0000000C00C0000000000000000000001
11111111111111111111111111111111111