111111111
1E1000001
111011C01
1000P0111
111111111