11111111111111111111111111111111111
100001000000001000000000000000010C1
10001111111000100000000100011111101
100011C0000000000000001100000001001
10001100C0011000110001010C000001001
1P001111111111111100100100011111001
1E000110000010000001000100010010001
10001110000010001001111110010100001
1000111110001000100000010C011111001
10000000000000000C00000000000000001
11111111111111111111111111111111111